20
12
OOOOOOOOOOOOOOOOOOOO
OOOOOOOOOOOOOOOOOOOO
OOOOOOOOOOOOOOOOOOOO
OOOOOOOXXXXXXOOOOOOO
OOOOOOOOOOOOXOOOOOOO
OOOOOOOOOOXOXOOOOOOO
OOOOOOOXXXXOXOOOOOOO
OOOOOOOXOOOOXOOOOOOO
OOOOOOOXXXXXXOOOOOOO
OOOOOOOOOOOOOOOOOOOO
OOOOOOOOOOOOOOOOOOOO
OOOOOOOOOOOOOOOOOOOO
